1 1 1 1 1 1 1 1 1 1 1 1 1 1 1
1 0 0 4 4 4 4 4 4 4 6 8 0 0 1
1 0 1 8 1 5 1 8 1 7 1 4 1 0 1
1 4 4 9 4 7 7 9 4 5 4 4 5 4 1
1 6 1 9 1 6 1 5 1 6 1 0 1 7 1
1 5 8 5 6 9 4 4 4 7 9 9 0 4 1
1 6 1 6 1 0 1 0 1 0 1 4 1 6 1
1 9 4 4 4 7 8 4 4 4 7 7 6 4 1
1 9 1 7 1 7 1 6 1 0 1 4 1 4 1
1 9 5 7 4 7 4 4 7 4 9 7 4 8 1
1 7 1 4 1 4 1 0 1 6 1 7 1 4 1
1 0 4 5 9 0 6 8 0 8 6 9 6 4 1
1 0 1 5 1 8 1 4 1 4 1 4 1 0 1
1 0 0 5 8 4 6 9 5 9 4 8 0 0 1
1 1 1 1 1 1 1 1 1 1 1 1 1 1 1
