1 1 1 1 1 1 1 1 1 1 1 1 1 1 1
1 0 0 4 4 4 4 9 0 4 9 7 0 0 1
1 0 1 8 1 9 1 7 1 0 1 6 1 0 1
1 0 4 9 4 8 0 7 9 4 4 4 4 5 1
1 7 1 6 1 4 1 4 1 4 1 4 1 4 1
1 4 4 6 9 7 4 7 4 4 7 4 7 4 1
1 5 1 4 1 5 1 0 1 7 1 0 1 4 1
1 6 9 0 8 7 8 4 4 9 9 0 0 0 1
1 4 1 4 1 6 1 6 1 9 1 8 1 4 1
1 4 4 7 7 4 4 4 0 4 9 4 8 4 1
1 0 1 4 1 8 1 4 1 4 1 0 1 5 1
1 0 4 0 4 4 7 7 6 5 4 5 6 8 1
1 0 1 4 1 7 1 7 1 4 1 4 1 0 1
1 0 0 4 4 7 4 5 6 4 8 7 0 0 1
1 1 1 1 1 1 1 1 1 1 1 1 1 1 1
