1 1 1 1 1 1 1 1 1 1 1 1 1 1 1
1 0 0 8 7 4 0 7 7 5 4 4 0 0 1
1 0 1 5 1 4 1 4 1 4 1 4 1 0 1
1 4 6 7 7 9 4 7 4 0 4 4 5 0 1
1 4 1 4 1 4 1 4 1 4 1 0 1 6 1
1 9 4 8 4 5 7 4 8 9 4 4 4 7 1
1 4 1 5 1 5 1 6 1 9 1 5 1 4 1
1 4 8 4 4 9 4 9 7 4 4 0 4 6 1
1 4 1 4 1 4 1 4 1 6 1 9 1 4 1
1 6 7 6 4 8 4 4 9 7 0 4 4 8 1
1 4 1 9 1 4 1 4 1 8 1 5 1 8 1
1 9 4 4 5 4 4 6 0 4 4 9 5 6 1
1 0 1 9 1 6 1 4 1 6 1 8 1 0 1
1 0 0 4 6 4 5 6 8 6 7 4 0 0 1
1 1 1 1 1 1 1 1 1 1 1 1 1 1 1
