1 1 1 1 1 1 1 1 1 1 1 1 1 1 1
1 0 0 4 8 4 4 4 4 4 7 4 0 0 1
1 0 1 4 1 4 1 4 1 4 1 4 1 0 1
1 7 4 7 4 4 8 4 4 8 9 4 4 4 1
1 7 1 6 1 4 1 6 1 4 1 4 1 4 1
1 4 4 9 9 4 5 0 9 0 9 8 5 5 1
1 4 1 4 1 7 1 5 1 9 1 4 1 4 1
1 6 5 7 4 9 4 4 8 4 8 4 0 5 1
1 5 1 5 1 5 1 4 1 4 1 0 1 6 1
1 4 4 4 4 7 5 5 9 8 4 5 4 4 1
1 4 1 4 1 4 1 6 1 5 1 4 1 4 1
1 4 5 5 7 7 0 8 5 7 4 5 9 4 1
1 0 1 0 1 6 1 4 1 7 1 9 1 0 1
1 0 0 4 4 4 5 4 4 5 4 6 0 0 1
1 1 1 1 1 1 1 1 1 1 1 1 1 1 1
