1 1 1 1 1 1 1 1 1 1 1 1 1 1 1
1 0 0 4 4 0 4 4 4 4 4 4 0 0 1
1 0 1 4 1 4 1 4 1 9 1 4 1 0 1
1 4 4 0 4 0 4 5 8 4 4 9 4 9 1
1 4 1 4 1 4 1 5 1 4 1 4 1 4 1
1 4 4 9 5 4 0 8 4 8 8 4 4 4 1
1 7 1 4 1 0 1 4 1 6 1 0 1 9 1
1 0 8 8 5 0 4 5 4 4 4 4 4 5 1
1 6 1 5 1 6 1 9 1 4 1 4 1 8 1
1 4 9 6 7 4 5 7 8 4 4 4 8 4 1
1 8 1 4 1 9 1 0 1 4 1 4 1 4 1
1 6 4 5 4 5 0 4 6 9 9 0 4 4 1
1 0 1 5 1 4 1 7 1 4 1 4 1 0 1
1 0 0 0 5 5 7 4 9 7 4 4 0 0 1
1 1 1 1 1 1 1 1 1 1 1 1 1 1 1
