1 1 1 1 1 1 1 1 1 1 1 1 1 1 1
1 0 0 9 0 5 7 4 4 5 4 9 0 0 1
1 0 1 4 1 4 1 8 1 4 1 7 1 0 1
1 7 5 7 9 4 0 9 7 7 0 5 4 4 1
1 4 1 4 1 4 1 4 1 8 1 9 1 0 1
1 4 4 7 4 4 4 9 5 4 7 4 5 4 1
1 4 1 4 1 7 1 5 1 4 1 4 1 4 1
1 8 4 8 8 4 0 0 8 7 4 9 4 8 1
1 4 1 9 1 6 1 7 1 4 1 9 1 6 1
1 4 4 5 9 9 4 4 6 4 4 7 8 0 1
1 4 1 4 1 4 1 5 1 0 1 0 1 5 1
1 5 0 5 4 8 7 5 4 5 6 7 9 4 1
1 0 1 4 1 6 1 5 1 6 1 7 1 0 1
1 0 0 6 4 9 4 7 4 4 4 5 0 0 1
1 1 1 1 1 1 1 1 1 1 1 1 1 1 1
