1 1 1 1 1 1 1 1 1 1 1 1 1 1 1
1 0 0 0 4 4 6 6 4 4 8 4 0 0 1
1 0 1 9 1 4 1 4 1 4 1 7 1 0 1
1 4 4 9 7 4 0 4 9 6 5 4 4 8 1
1 4 1 5 1 7 1 0 1 0 1 7 1 4 1
1 0 4 7 9 4 4 0 6 4 4 8 4 4 1
1 4 1 9 1 4 1 9 1 5 1 4 1 4 1
1 4 4 9 4 6 4 4 4 4 9 4 4 5 1
1 4 1 8 1 7 1 9 1 4 1 4 1 0 1
1 4 4 4 4 4 4 7 9 4 5 0 7 0 1
1 9 1 4 1 8 1 8 1 4 1 0 1 5 1
1 7 5 4 7 0 6 7 4 4 4 4 4 8 1
1 0 1 4 1 7 1 9 1 4 1 4 1 0 1
1 0 0 6 4 7 8 7 4 4 7 4 0 0 1
1 1 1 1 1 1 1 1 1 1 1 1 1 1 1
