1 1 1 1 1 1 1 1 1 1 1 1 1 1 1
1 0 0 5 4 8 9 0 0 6 4 4 0 0 1
1 0 1 4 1 4 1 4 1 4 1 0 1 0 1
1 8 9 0 4 8 5 6 8 4 6 8 4 4 1
1 8 1 4 1 4 1 6 1 7 1 7 1 5 1
1 7 9 4 9 4 4 9 4 4 9 4 9 7 1
1 7 1 8 1 4 1 5 1 4 1 4 1 6 1
1 9 6 9 4 4 4 4 4 7 4 9 4 4 1
1 0 1 0 1 4 1 4 1 4 1 9 1 9 1
1 6 4 0 4 6 9 4 7 9 4 4 8 4 1
1 5 1 7 1 6 1 4 1 7 1 8 1 4 1
1 7 0 5 4 6 4 5 0 4 8 5 4 4 1
1 0 1 4 1 9 1 6 1 7 1 4 1 0 1
1 0 0 5 7 7 7 4 9 4 4 7 0 0 1
1 1 1 1 1 1 1 1 1 1 1 1 1 1 1
