1 1 1 1 1 1 1 1 1 1 1 1 1 1 1
1 0 0 4 4 0 4 9 8 6 4 4 0 0 1
1 0 1 4 1 9 1 8 1 4 1 8 1 0 1
1 5 8 9 0 7 8 4 4 9 4 4 8 5 1
1 4 1 7 1 4 1 4 1 0 1 4 1 9 1
1 9 8 8 4 4 6 4 9 4 6 5 7 4 1
1 4 1 6 1 7 1 7 1 8 1 5 1 0 1
1 6 5 7 4 4 4 4 0 9 4 9 4 4 1
1 5 1 6 1 9 1 4 1 4 1 8 1 4 1
1 7 6 9 4 4 9 7 5 4 4 5 9 5 1
1 5 1 5 1 4 1 6 1 4 1 8 1 8 1
1 5 5 9 5 4 4 9 4 4 4 4 9 5 1
1 0 1 9 1 5 1 5 1 4 1 0 1 0 1
1 0 0 4 8 8 8 6 4 8 4 7 0 0 1
1 1 1 1 1 1 1 1 1 1 1 1 1 1 1
