1 1 1 1 1 1 1 1 1 1 1 1 1 1 1
1 0 0 4 4 7 5 4 9 9 4 7 0 0 1
1 0 1 7 1 4 1 6 1 0 1 4 1 0 1
1 6 0 5 4 4 4 4 5 9 7 6 9 4 1
1 9 1 8 1 7 1 4 1 4 1 4 1 8 1
1 9 9 7 4 4 0 9 7 9 0 4 4 8 1
1 8 1 4 1 4 1 4 1 9 1 4 1 4 1
1 9 0 4 8 7 6 4 4 4 8 0 6 4 1
1 4 1 9 1 0 1 4 1 7 1 5 1 4 1
1 8 4 9 7 4 4 6 4 4 5 4 0 9 1
1 7 1 7 1 6 1 4 1 5 1 4 1 4 1
1 6 0 6 4 4 4 4 5 8 4 4 4 4 1
1 0 1 7 1 4 1 4 1 4 1 4 1 0 1
1 0 0 7 9 8 6 5 4 7 5 7 0 0 1
1 1 1 1 1 1 1 1 1 1 1 1 1 1 1
