1 1 1 1 1 1 1 1 1 1 1 1 1 1 1
1 0 0 0 8 0 0 0 0 0 0 0 0 0 1
1 0 1 0 1 0 1 0 1 0 1 0 1 0 1
1 0 4 5 5 5 4 4 4 4 4 4 4 0 1
1 0 1 0 1 0 1 0 1 0 1 0 1 0 1
1 0 0 0 0 0 0 0 0 0 0 0 0 0 1
1 0 1 0 1 0 1 0 1 0 1 0 1 0 1
1 0 8 4 0 0 0 0 6 0 0 0 0 0 1
1 0 1 0 1 0 1 0 1 0 1 0 1 0 1
1 0 0 0 0 0 0 0 0 0 0 0 0 0 1
1 0 1 0 1 0 1 0 1 0 1 6 1 0 1
1 0 0 0 9 0 0 0 7 0 0 4 0 0 1
1 0 1 0 1 0 1 0 1 0 1 7 1 0 1
1 0 0 0 0 0 0 0 0 0 0 0 0 0 1
1 1 1 1 1 1 1 1 1 1 1 1 1 1 1
