1 1 1 1 1 1 1 1 1 1 1 1 1 1 1
1 0 0 0 7 0 0 0 0 0 0 0 0 0 1
1 6 1 0 1 0 1 0 1 0 1 0 1 0 1
1 0 3 7 3 3 3 3 3 3 3 3 3 0 1
1 5 1 0 1 0 1 0 1 0 1 0 1 0 1
1 0 0 0 0 0 0 0 0 0 0 0 0 0 1
1 8 1 0 1 0 1 0 1 0 1 0 1 0 1
1 0 7 3 0 0 0 0 5 0 0 0 0 0 1
1 0 1 0 1 0 1 0 1 0 1 0 1 0 1
1 0 0 0 0 0 0 0 0 0 0 0 0 0 1
1 0 1 0 1 0 1 0 1 0 1 5 1 0 1
1 0 0 0 8 0 0 0 6 0 0 3 0 0 1
1 0 1 0 1 0 1 0 1 0 1 6 1 0 1
1 0 0 0 0 0 0 0 0 0 0 0 0 0 1
1 1 1 1 1 1 1 1 1 1 1 1 1 1 1
